NO ./test_assets/valid_texture.xpm
SO ./test_assets/valid_texture.xpm
WE ./test_assets/valid_texture.xpm
EA ./test_assets/valid_texture.xpm
F 220,100,0
C 225,30,0

11111
10N01
1000   # <- строка короче: при выравнивании возникнет пробел на краю -> незамкнутость
11111
