NO ./test_assets/valid_texture.xpm
SO ./test_assets/valid_texture.xpm
WE ./test_assets/valid_texture.xpm
EA ./test_assets/valid_texture.xpm
F 220,100,0
C 225,30,0

11111
10N01
10201  # содержит недопустимый символ '2'
11111
