NO ./test_assets/valid_texture.xpm
SO ./test_assets/valid_texture.xpm
WE ./test_assets/valid_texture.xpm
EA ./test_assets/valid_texture.xpm
F 220,100,0
C 225,30,0

11111
1 0N1   # пробел внутри строки, при трактовке как внешней области может привести к "утечке"
10001
11111
