NO textures/leaves.xpm
SO textures/space.xpm
WE textures/space.xpm
EA textures/space.xpm

F 220,100,0
C 225,30,0

   11 1111111111111111111111111111
        1000000000110000000000001
        1011000001110000000000001
        1001000000000000000000001
11111111101100000110000000000001
100000000011000001110111101111111
111101111111111110000001000111        
111101111 11111011101010010001
11000000110101011100000010001
10000000000000001100000010001
1000000000000000110101001000111
11000001110101011111011100N0001
11110111 1110101 10011101000111
11111111 1111111 1111111111111
