NO fdf.h
SO fdf.h
WE fdf.h
EA fdf.h
NO ahsdd
F 220,100,0
C 225,30,0

   11 1111111111111111111111111111
        1000000000110000000000001
        1011000001110000000000001
        1001000000000000000000001
11111111101100000110000000000001
100000000011000001110111101111111
1111011111111111100000010001          1111
111101111 11111N11101010010001
11000000110101011100000010001
10000000000000001100000010001
1000000000000000110101001000111
110000011101010111110111100001
11110111 1110101 10111101000111
11111111 1111111 1111111111111
