NO fdf.h
SO main.c
WE cub.h

EA mlx.h
F 255,0,0

C 0,0,255

11111111111
1000N01001
1001001111
11110011
1001111
1111