NO ./test_assets/valid_texture.xpm
WE ./test_assets/valid_texture.xpm
C 220,100,0
F 220,100,0
SO ./test_assets/valid_texture.xpm
EA ./test_assets/valid_texture.xpm


11111
10N01
10001
11111